* 思路

*******+**
******* **
****    **
**   *****
** **F****
**    ****
**********
